#fileout
mycore1.eps
# pitch
1.0
#layout (hex/square)
h
#number of rings
7
#symmetry
1
#colors
                0   1   1   1   1   1   1   0
              1   1   1   1   1   1   1   1   1
            1   1   1   1   1   1   1   1   1   1
          1   1   1   1   1   1   1   1   1   1   1
        1   1   1   1   1   1   1   1   1   1   1   1
      1   1   1   1   1   1   1   1   1   1   1   1   1
    1   1   1   1   1   1   1   1   1   1   1   1   1   1
  0   1   1   1   1   1   1   1   1   1   1   1   1   1   0
    1   1   1   1   1   1   1   1   1   1   1   1   1   1
      1   1   1   1   1   1   1   1   1   1   1   1   1
        1   1   1   1   1   1   1   1   1   1   1   1
          1   1   1   1   1   1   1   1   1   1   1
            1   1   1   1   1   1   1   1   1   1
              1   1   1   1   1   1   1   1   1
                0   1   1   1   1   1   1   0
-0.0 -0.0
